E000001010101010100
1010101001010100010
1010101010101010101
1001010101010101010
1100101010101010101
1110011010101010001
1110000000000000101
1111111111111111101
111101010101010100S